SetGrid 28 31 24 24
AddTile 1 DebugTile 0
AddTile 2 SolidFloor 1
AddTile 6 Floor 0
AddTile 10 Pellet 0
AddTile 11 WallDown 1
AddTile 12 WallUp 1
AddTile 13 WallLeft 1
AddTile 14 WallRight 1
AddTile 15 BigCorner1 1
AddTile 16 BigCorner2 1
AddTile 17 BigCorner3 1
AddTile 18 BigCorner4 1
AddTile 19 SmallCorner1 1
AddTile 20 SmallCorner2 1
AddTile 21 SmallCorner3 1
AddTile 22 SmallCorner4 1
SetTiles
18 12 12 12 12 12 12 12 12 12 12 12 12 17 18 12 12 12 12 12 12 12 12 12 12 12 12 17
13 10 10 10 10 10 10 10 10 10 10 10 10 14 13 10 10 10 10 10 10 10 10 10 10 10 10 14
13 10 22 11 11 21 10 22 11 11 11 21 10 14 13 10 22 11 11 11 21 10 22 11 11 21 10 14
13 10 14 6 6 13 10 14 6 6 6 13 10 14 13 10 14 6 6 6 13 10 14 6 6 13 10 14
13 10 20 12 12 19 10 20 12 12 12 19 10 20 19 10 20 12 12 12 19 10 20 12 12 19 10 14
13 10 10 10 10 10 10 10 10 10 10 10 10 10 10 10 10 10 10 10 10 10 10 10 10 10 10 14
13 10 22 11 11 21 10 22 21 10 22 11 11 11 11 11 11 21 10 22 21 10 22 11 11 21 10 14
13 10 20 12 12 19 10 14 13 10 20 12 12 17 18 12 12 19 10 14 13 10 20 12 12 19 10 14
13 10 10 10 10 10 10 14 13 10 10 10 10 14 13 10 10 10 10 14 13 10 10 10 10 10 10 14
16 11 11 11 11 21 10 14 16 11 11 21 6 14 13 6 22 11 11 15 13 10 22 11 11 11 11 15
6 6 6 6 6 13 10 14 18 12 12 19 6 20 19 6 20 12 12 17 13 10 14 6 6 6 6 6
6 6 6 6 6 13 10 14 13 6 6 6 6 6 6 6 6 6 6 14 13 10 14 6 6 6 6 6
6 6 6 6 6 13 10 14 13 6 22 11 11 2 2 11 11 21 6 14 13 10 14 6 6 6 6 6
12 12 12 12 12 19 10 20 19 6 14 6 6 6 6 6 6 13 6 20 19 10 20 12 12 12 12 12
10 10 10 10 10 10 10 6 6 6 14 6 6 6 6 6 6 13 6 6 6 10 10 10 10 10 10 10
11 11 11 11 11 21 10 22 21 6 14 6 6 6 6 6 6 13 6 22 21 10 22 11 11 11 11 11
6 6 6 6 6 13 10 14 13 6 20 12 12 12 12 12 12 19 6 14 13 10 14 6 6 6 6 6
6 6 6 6 6 13 10 14 13 6 6 6 6 6 6 6 6 6 6 14 13 10 14 6 6 6 6 6
6 6 6 6 6 13 10 14 13 6 22 11 11 11 11 11 11 21 6 14 13 10 14 6 6 6 6 6
18 12 12 12 12 19 10 20 19 6 20 12 12 17 18 12 12 19 6 20 19 10 20 12 12 12 12 17
13 10 10 10 10 10 10 10 10 10 10 10 10 14 13 10 10 10 10 10 10 10 10 10 10 10 10 14
13 10 22 11 11 21 10 22 11 11 11 21 10 14 13 10 22 11 11 11 21 10 22 11 11 21 10 14
13 10 20 12 17 13 10 20 12 12 12 19 10 20 19 10 20 12 12 12 19 10 14 18 12 19 10 14
13 10 10 10 14 13 10 10 10 10 10 10 10 6 6 10 10 10 10 10 10 10 14 13 10 10 10 14
16 11 21 10 14 13 10 22 21 10 22 11 11 11 11 11 11 21 10 22 21 10 14 13 10 22 11 15
18 12 19 10 20 19 10 14 13 10 20 12 12 17 18 12 12 19 10 14 13 10 20 19 10 20 12 17
13 10 10 10 10 10 10 14 13 10 10 10 10 14 13 10 10 10 10 14 13 10 10 10 10 10 10 14
13 10 22 11 11 11 11 15 16 11 11 21 10 14 13 10 22 11 11 15 16 11 11 11 11 21 10 14
13 10 20 12 12 12 12 12 12 12 12 19 10 20 19 10 20 12 12 12 12 12 12 12 12 19 10 14
13 10 10 10 10 10 10 10 10 10 10 10 10 10 10 10 10 10 10 10 10 10 10 10 10 10 10 14
16 11 11 11 11 11 11 11 11 11 11 11 11 11 11 11 11 11 11 11 11 11 11 11 11 11 11 15
