SetGrid 27 30 24 24
AddTile 6 Floor 0
AddTile 7 Wall 1
SetTiles
6 6 6 6 6 6 6 6 6 6 6 6 6 7 6 6 6 6 6 6 6 6 6 6 6 6 6
6 6 6 6 6 6 6 6 6 6 6 6 6 7 6 6 6 6 6 6 6 6 6 6 6 6 6
6 6 7 7 7 6 6 7 7 7 7 6 6 7 6 6 7 7 7 7 6 6 7 7 7 6 6
6 6 7 7 7 6 6 7 7 7 7 6 6 7 6 6 7 7 7 7 6 6 7 7 7 6 6
6 6 6 6 6 6 6 6 6 6 6 6 6 6 6 6 6 6 6 6 6 6 6 6 6 6 6
6 6 6 6 6 6 6 6 6 6 6 6 6 6 6 6 6 6 6 6 6 6 6 6 6 6 6
6 6 7 7 7 6 6 7 6 6 7 7 7 7 7 7 7 6 6 7 6 6 7 7 7 6 6
6 6 6 6 6 6 6 7 6 6 6 6 6 7 6 6 6 6 6 7 6 6 6 6 6 6 6
6 6 6 6 6 6 6 7 6 6 6 6 6 7 6 6 6 6 6 7 6 6 6 6 6 6 6
7 7 7 7 7 6 6 7 7 7 7 6 6 7 6 6 7 7 7 7 6 6 7 7 7 7 7
7 7 7 7 7 6 6 7 6 6 6 6 6 6 6 6 6 6 6 7 6 6 7 7 7 7 7
7 7 7 7 7 6 6 7 6 6 6 6 6 6 6 6 6 6 6 7 6 6 7 7 7 7 7
7 7 7 7 7 6 6 7 6 6 7 7 6 6 6 7 7 6 6 7 6 6 7 7 7 7 7
6 6 6 6 6 6 6 6 6 6 7 6 6 6 6 6 7 6 6 6 6 6 6 6 6 6 6
6 6 6 6 6 6 6 6 6 6 7 6 6 6 6 6 7 6 6 6 6 6 6 6 6 6 6
7 7 7 7 7 6 6 7 6 6 7 7 7 7 7 7 7 6 6 7 6 6 7 7 7 7 7
7 7 7 7 7 6 6 7 6 6 6 6 6 6 6 6 6 6 6 7 6 6 7 7 7 7 7
7 7 7 7 7 6 6 7 6 6 6 6 6 6 6 6 6 6 6 7 6 6 7 7 7 7 7
7 7 7 7 7 6 6 7 6 6 7 7 7 7 7 7 7 6 6 7 6 6 7 7 7 7 7
6 6 6 6 6 6 6 6 6 6 6 6 6 7 6 6 6 6 6 6 6 6 6 6 6 6 6
6 6 6 6 6 6 6 6 6 6 6 6 6 7 6 6 6 6 6 6 6 6 6 6 6 6 6
6 6 7 7 7 6 6 7 7 7 7 6 6 7 6 6 7 7 7 7 6 6 7 7 7 6 6
6 6 6 6 7 6 6 6 6 6 6 6 6 6 6 6 6 6 6 6 6 6 7 6 6 6 6
6 6 6 6 7 6 6 6 6 6 6 6 6 6 6 6 6 6 6 6 6 6 7 6 6 6 6
7 7 6 6 7 6 6 7 6 6 7 7 7 7 7 7 7 6 6 7 6 6 7 6 6 7 7
6 6 6 6 6 6 6 7 6 6 6 6 6 7 6 6 6 6 6 7 6 6 6 6 6 6 6
6 6 6 6 6 6 6 7 6 6 6 6 6 7 6 6 6 6 6 7 6 6 6 6 6 6 6
6 6 7 7 7 7 7 7 7 7 7 6 6 7 6 6 7 7 7 7 7 7 7 7 7 6 6
6 6 6 6 6 6 6 6 6 6 6 6 6 6 6 6 6 6 6 6 6 6 6 6 6 6 6
6 6 6 6 6 6 6 6 6 6 6 6 6 6 6 6 6 6 6 6 6 6 6 6 6 6 6
